int highwayLayout[100] = {
	0, 0, 0, 0, 0, 0, 0, 0, 0, 0,
	0, 1, 1, 0, 0, 0, 0, 1, 1, 0,
	0, 0, 0, 1, 0, 0, 1, 0, 0, 0,
	0, 0, 0, 1, 0, 0, 1, 0, 0, 0,
	0, 0, 0, 1, 0, 0, 1, 0, 0, 0,
	0, 0, 0, 1, 0, 0, 1, 0, 0, 0,
	0, 0, 0, 1, 0, 0, 1, 0, 0, 0,
	0, 0, 0, 1, 0, 0, 1, 0, 0, 0,
	0, 1, 1, 0, 0, 0, 0, 1, 1, 0,
	0, 0, 0, 0, 0, 0, 0, 0, 0, 0
};

int livingLayout[100] = {
	0, 0, 0, 0, 0, 0, 0, 0, 0, 0,
	0, 0, 0, 0, 1, 0, 0, 0, 0, 1,
	0, 0, 0, 1, 0, 0, 0, 0, 1, 0,
	0, 0, 1, 0, 0, 0, 0, 1, 0, 0,
	0, 1, 0, 0, 0, 0, 1, 0, 0, 0,
	1, 0, 0, 0, 0, 1, 0, 0, 0, 0,
	0, 0, 0, 0, 1, 0, 0, 0, 0, 0,
	0, 0, 0, 1, 0, 0, 0, 0, 1, 0,
	0, 0, 1, 0, 0, 0, 0, 1, 0, 0,
	0, 0, 0, 0, 0, 0, 1, 0, 0, 0
};

int killLayout[100] = {
	1, 0, 0, 0, 0, 0, 0, 0, 0, 1,
	0, 1, 0, 0, 0, 0, 0, 0, 1, 0,
	0, 0, 1, 0, 0, 0, 0, 1, 0, 0,
	0, 0, 0, 1, 0, 0, 1, 0, 0, 0,
	0, 0, 0, 0, 0, 0, 0, 0, 0, 0,
	0, 0, 0, 0, 0, 0, 0, 0, 0, 0,
	0, 0, 0, 1, 0, 0, 1, 0, 0, 0,
	0, 0, 1, 0, 0, 0, 0, 1, 0, 0,
	0, 1, 0, 0, 0, 0, 0, 0, 1, 0,
	1, 0, 0, 0, 0, 0, 0, 0, 0, 1
};